10	11									
1	2	3	1	1	1	1	1	1	4	1
1	0	0	0	0	0	0	0	0	0	1
1	0	10	0	16	0	22	0	28	0	1
1	0	11	0	17	0	23	0	29	0	1
1	0	12	0	18	0	24	0	30	0	1
1	0	13	0	19	0	25	0	31	0	1
1	0	14	0	20	0	26	0	32	0	1
1	0	15	0	21	0	27	0	33	0	1
1	0	0	0	0	0	0	0	0	0	1
1	1	1	1	1	1	1	1	1	1	1